Chef and String - XYSTR
Count Subarrays - SUBINC
Alternating subarray prefix - ALTARAY
Chef and Wedding Arrangements - CHEFWED
Chef and Frogs - FROGV
Watching CPL - WIPL
N different palindromes - NDIFFPAL
(CH) Bear and Sorted Rows - SORTROW
Gravity Guy - GRGUY
Decomposition Reaction - DCP
Chef and String - CHRL2
Sherlock and the Grid - GRID
Count Substrings - STRSUB
XOR with Subset - XORSUB
Subtree Removal - SUBREM
Pizza Delivery - DBOY
Car-pal Tunnel - CARPTUN
Dessert Wizard - DELISH
Billiards - CDQU5
Chef and Good Subsequences - GDSUB
Delivery Man - TADELIVE
Choosing Problems - MCO16503
Way Out - WOUT
String Merging - STRMRG
Aujasvit and the Circle Game - CIRCLEGAME
Polo the Penguin and the Test - PPTEST
Total Diamonds - VK18
Chef and Way - CHRL4
Bhallaladeva - AMR15D
Little Elephant and T-Shirts - TSHIRTS
Art in Digital Age - SMPAINT
Byteland Tours - TOURBUS
Spheres - KSPHERES
Barcelona Gameplay Tactics - FCBARCA
Merging Binary Strings - MERGEBS
Count Sequences - CSEQ
Subtraction Game 2 - AMSGAME2
K-Subarrays - CHESUB
Alok-nath and His Sanskars - SANSKAR
Subarray LCM - SUBLCM
Steady tables - STDYTAB
Chef and Big Soccer - CHEFSOC2
Chef and Strange Addition - CHEFADD
Save The Princess - SHIRO
MasterChef - MCHEF
Break Up - ZCO15001
Maxim and Progressions - MAXPR
Chef and Rectangle Array - CHSQARR
Maximum Topological Sort - MAXTOPO
Boolean Game - BOOLGAME
W String - WSTRING
Swapping - SFRV
Washing Windows - APARTS
Random decreasing function - RDF
Subsequence Frequency Counting - SUBSFREQ
Little Elephant and Painting - LEPAINT
List Editing - EDITLIST
Player - RRPLAYER
Circular Merging - CIRMERGE
Tree Permutations - TREEPERM
Beautiful Bricks - BBRICKS
Gift and Chef - GIFTCHEF
Encoding - ENCODING
Finding Hardest Sum Value - KOL15B
The Number Of Solutions - CNTSOLS
Lock-Free Stack - LFSTACK
Smallest Beautiful Number - LSTBTF
Chef and Filters - CHEFFILT
Little Elephant and Mouses - LEMOUSE
Bamboo Art - ZCO16002
Chef and Bitwise OR Operation - CHEFAOR
Choosing from Buckets - BUCKETS
Launch Tower - ACM14AM3
Chef and Words - CHEFWORD
Change the Signs - CHSIGN
Chef and math - CHEFMATH
Chef and Magic Arrays - MARRAYS
Chef And Fibonacci Array - CHEFFA
Hiring Workers - HIRINGWO
Need More Diamonds - DIAMOND
Online Shopping - COUPON
Inversion sorting - CARLOS
Insanely Hard School Exams - ACCBIP
Chef and Bracket-Pairs - CHEFBR
Chef and Segments - CHSGMNTS
(Challenge) Nanobots - NBOTS
Lucky Driving - LUKYDRIV
Construct Array - CARR
Strategy for the World Cup - WORLDCUP
Beautiful Subsequence - BEAUSUB
Cards, bags and coins - ANUCBC
Mountain Holidays 2 - MOU2H
Chef and Gift - CHGIFT1
The Lost Arithmetic Sequences - TAASEQ
Mex Subsequence - MEXSUB
Family Tree - FAMTREE
Expected Change - EXPCH
Matrix - MATRIX2
Little Elephant and Balloons - LEBALONS
Chef and Two String - CHEFTWOS
Empire Business  - SOLDVAL
Music & Lyrics - LYRC
Churu and lost string - CLOST
Kira Loves Palindromes - KLPM
Longest Increasing Subsequences - MAKELIS
Time to Study Graphs with Chef - CHEFGRPH
Puppy and Board - TUZGMBR
Meteor - METEORAK
Domino Solitaire - DOMSOL
Coloring A Tree - COLTREE
Mr Thakkar want to go dream land - COAD03
Divide Candies - EQDIV
Chef and Inflation - CHINFL
Sereja and LCM - SEALCM
Fibonacci concatenation - FIBOSEQ
Even Sequence - EVSTR
Counting Strings - TACNTSTR
Purify It - PRFYIT
(Challenge) Dynamic Hull - DYNHUL
Robot Walk - RWALK
Celebrity In Trouble - SCC5
Digits Cannot Separate - DIGITSEP
Sereja and Arrays - SEARRAYS
Nuttela Path Unit - ENOC1
Chef and Roads - CL16BF
Sequence Containment - KGP14B
Hit the Coconuts - CCC
Jeremy gets a gift - CLLEXO
Book Game with Chef - ANUBGC
Maximum Plus - PLUS
Super Hashing - AUHASH
Chef and Numbers - CHRL3
Chef and Soccer - CHEFSOC
Method Resolution Order - MRO
Two Coins - TWOCOINS
Little Elephant and Blocks - LEBLOCKS
Chefs Homework Dilemma - HMWPRB
Telephone Network - TELNET
Music Shopping - SONGSHOP
Candy Collecting Game - CANDYGAM
Fill The Boxes - FILLBOX
Parenthesis with Maximum Sum Subarray - SUBARRAY
Jump mission - JUMP
Total Palindromic Numbers - AOPN
Dividing Products - DIVPRO
Sealing up - SEALUP
Reign 2 - REIGN2
Array Operation - SPIT04
Marble Game - ENC2020A
Completing favorite game - FAVGAME
Sereja and Equality - SEAEQ
Akshay and Teacher - ATCH
Too Much Sweetness - ABX02
Matching Parenthesis - COCA2003
CAO Stage-3 - CAOS3
Sereja and Tree 2 - SEATR2
Xor Decomposition - XDCOMP
Learning Dishes - UPDOTR
Tennis Tournament - TOURNAM
Chef and Girls - CHEFGIRL
Array Division - DIVIDEARR
Inverse Knapsack - INVSACK
Subarray Sum - SUMSUB
Grid Path - GRIDPA
Girl Friend and String Gift - CHGLSTGT
Visiting Friends - MCO16405
Polo the Penguin and the Tree - PPTREE
Professor on a Trip - PROFTRIP
Sereja and Game - SEAGM
Jimma and Chingam - CHN15C
Expected GCD - EXPGCD
Cosmic Temple - COSTEMP
The In-XOR-able Task - XOXO
Knight Covering - KNICOV
Cardinality - CARDINAL
Random Rudreshwar - ANURRZ
Chefina on a Trip - CHEFTRIP
Permutation Split - PERMSPL
Tree Upshot - TREUPS
Sereja and GCD 2 - SEAGCD2
The Christmas Gift - KOL1502
Maximise the Minimum - MAXMINK
Chef And Hungry Birds - HBIRD
Jealous Numbers - NUMSET
Inversions in Permutations - KPERM
Lazy Chozi - SS1
Polynomial Partition Function - PARPOLY
Ish Food Distribution - ISHGRAPH
Escape One - CHEFZRON
Number of Paths - NUMPATH
Favourite Numbers - FAVNUM
Flash vs QuickSilver - FLAASH
Maximize the Tax - MAXTAX
TWO SACKS OF HAPPINESS - TSOH
Chef and Pepperoni Pizza Again - PEPPERA
Tree Height - MCO16403
Up for a Game - CLGAME
How to Write a Message - STRAB
Abdullah and Toll Discounts - ABDTOLL
Maximum Score - MAXSCOR
Little Elephant and Magic - LEMAGIC
Mathison and the teleportation game - MATTEG
Traveling Plan - TABUS
Lucky Fives - LFIVES
Node Codon - CODON
Vaibhav and Ministers - VAIMIN
FastFood Combos - FFCOMB
The Minimum Game - TREEMIN
Interview Scheduling - KGP14D
Reach The Temple - TEMPLE
Optimal Partition - KGP16F
Minimalistic - RDC2
Chef and Combinatorics - GERALD05
Profitable Paths 2 - PRT2
Company and Club Hierarchies - COMPCLUB
Make array great again - MAGA
Hopscotch - GIFTPAIRS
Chef And Division - CEFDIV
Binary Land - BINLAND
Battle Royale - BTTLRYL
Node Marking - NDMRK
Teddy and his Mission - LAEDDIS
Sereja and Bubble Sort - SEABUB
Campus Drive - CPC4
Is it Sorted or Not, That is the Question - GRUSORT
Blackjack - BLKJK
Fluffy and Flippy Bird - MCO16303
Chef and Amazingness of Numbers - CHEFNUM
Exploring Undiscovered Planets - TRIPPY
Torque and edges - TRANDED
Wanderer - WNDR
Prefix And - ANDPREF
Neil and his Binary Tree - GOODBINTREE
Samosa Bhai and his Courier Company - KOL1506
Candidate walk - LCH15CD
Counting Lights - MCO16105
Zombinatorial - FOMBRO
Partition into Permutations - PERMPART
Jump & Reach - JUMPLS1
Tree Distance Sum - TREEDIST
Fluffy has a Robot - MCO16402
Animesh practices some programming contests - CHN03
Spectacular Activity Selection - SPECTAC
Chef Queries - CDVA1605
K-Tuple Tree - KTTREE
Permutations - DIVPERMS
Devu and Locks - DEVLOCK
Snakes capturing the Mongoose Cities - CAPTCITI
Joined Subarrays on Tree - JTSARTR
After the War, Aid - SOPC011
Sereja and Stones - SEASTONE
Maximizing Marks - EXAM
Chess Kings Chasing Game - CKCGAME
And Tuples - ANDTUPLE
Tree Unattractiveness - TREEUNAT
Chef Rami and Inventions - CHEFRAMI
Grumpy Granny - GRUMPMA
Black and Red vertices of Tree - BLREDSET
Little Elephant and Colored Coins - LECOINS
Chef and Average on a Tree - L56AVG
Lazy Machine - LAZYMACHINE
Updating Edges on Trees - UPDTREE
Chef and Chefness - CSUBSEQ
Chef and Jail - CHFOP
Shinigami and Apples - SHINAPP
Dakimakura Distribition - DAKIMAKU
Agents on mission - PERRY
Chef and Gordon Ramsay 2 - CHGORAM2
Lousy Game - BUG2K16C
Game of Length - LENGAME
Knight Moving - KNGHTMOV
Andrew and the Balls - AMBALLS
Devus and their voting system - DEVVOTE
git - AMGIT
Chef and Sad Pairs - SADPAIRS
Playing World War II - KOL16A
Disconnecting Cities - DICITIES
Hiring Chefs - HIRING
Magical Subsequence - MSUB121
Mumbai N00B - VIACST
Queries with GCD - GQR
Count The Arrays - COUARR
Cool Dude Laxman - ACM14KG5
Dearrangement Error - DEARRERR
Valet Parking - VALET
Pilgrimage - KGP14H
Arrays Sum - ARRAYSUM
Tree and Extra Edge - TREEDGE
GCD Partitions - ECJAND
Drawing Lines - DLINE
Alice And The Coin Game - COINGME
Chef and a New Home - COCR103
Numbers Game - LIKECS04
XOR Sum - AMXOR
Party Planning - INVITES
Elevator - ELEVATR
Weasel finds Staircase - WEASELSC
Sereja and BOX - SEABOX
Deja Vu - DEJAVU
Bear and Bribing Tree - BRIBETR
Misha and Gym - MGCHGYM
Pyramid of string - PATTERNG
Linear Combination - MODPARRS
Digit Bounded Numbers - INTERVCH
Will and Closed Set - CHEFCLOS
Reap What You Sow - SOPC012
Slingshot - SLING
Hard Disk - KAN13A
Solving the Practice Contest - ACM14KN2
Three Bikes - THREEBIKES
Modular Circular Permutations - MODCIRC
Kejriwal ki Jhadu - CRANBROM
Power Sums - POWSUMS
Weird Coins - SPAR3
Gun Distribution - GUNDIS
Partitioning Vijju - VIJJUPAR
Saitama got a date! - ECJAN20G
Sequence Transmission - AMSEQT
Stand Up - STANDUP
Chef and LCS - CHEFKLCS